11111111111111111111111111111111
10000000000000000000000000000C01
10000000000000000000000000000001
100001000P0000000001000000100001
10000000100000000011010000000111
10000000000000000010110000000001
100000000000C0000011101000000001
10000000000E00000000010000000001
10000000000000000000000000000101
10000100000000000001000010000001
1000000010000000000101E000011111
10000000000000000001100000000001
100000000000C0000000101000000001
10000000000000000000010000000001
10000000000000000000000000000101
10000100000000000001000000100001
10000000100000000001010000011001
11111111111111111111111111111111