111111111111111111111111111111111111111
100000000000000000000000000000000000001
100000000000000000000000000000000000101
100001000P00000000010000001000000000001
100000001000000000110100000001111111001
100000000000000000101100000000000000001
100000000000C00000111010000000000000001
10000000000E000000000100000000000000001
100000000000000000000000000000000000001
100000000000000000000000000000000000101
1000010000000000000100000010000P0000001
111111111111111111111111111111111111111