1111111111111111111111111111111111111111
10000000000000000000000000000000011000C1
1000000000000000000000000000000000000011
100001000P000000000100000010000000000001
1000000010000000000101000000011100111101
1C0000000000000000E110000000000011000001
100000000000C000000010100000000000110001
1000000000000000000001000000000001100001
1000000000000000000000000000000000000001
1000000000000000000000000000000000000011
1000010000000000000100000010000000000001
1000000010000000000101000000011100111101
1000000000000000000110000000000000000001
100000000000C000000010100000000011000001
1000000000000000000001000000000011000001
1000000000000000000000000000000011000011
1000010000000000000100000010000011000001
1000000010000000000101000000011100111101
100000000000000000011000000000000000C001
100000000000C000000010100000000000000001
1000000000000000000001000000000000000001
1000000000000000000000000000000000000001
1000000000000000000000000000000011000001
1000010000000000000100000010000000110001
1000000010000000000101000000011111001001
1000000000000000000110000000000001100001
1000000000000000000001111111010101000001
1111111110010101000000000000000000000001
1111111111111111111111111111111111111111