111111111111111111111111111111
100000000000000000000000000C01
100000000000000000000000000001
100001000P00000000010000000001
100000001000000000110100000111
100000000000000000101100000001
100000000000C00000111010000001
10000000000E000000000100000001
100000000000000000000000000101
100001000000000000010000100001
100000001000000000010100001111
100000000000000000011000000001
100000000000C00000001010000001
100000000000000000000100000001
100000000000000000000000000001
111111111111111111111111111111