111111111111111111111111111111111111111
1000000000000000000000000000000C0000001
100000000000000000000000000000000000101
100001000P00000000010000001000000000001
100000001000000000110100000001111111001
100000000000000000101100000000000000001
100000000010C00000111010000000000000001
100000000000000000000100000000000000001
100000000000000000000000000000000000001
100000000000000000000000000000000C00101
100001000000000000010000001000000000001
100000001000000000010100000001111111001
100000000000000000011000000000000000001
100000000000000000001010000001000000001
10000000000000000000010000001E100000001
100000000000000000000000000001000000101
100001000000000000010000001000000000001
100000001000000000010100000001111111001
100000000000000000011000000000000000001
100000000000C00000001010000000000000001
100000000000000000000100000000000000001
100000000000000000011000000000000000001
100000000000C00000001010000000000000001
100000000000000000000100000000000000001
100001000000000000010000001000000000001
100001000000000000010000001000000000001
111111111111111111111111111111111111111